CCCCCCCCCCCCCCCCCCCCCCCCCCCCCC
CTTSSSSSSCSSSSSSSSSSDSSSSSCSRC
CTTSSRSSSSSSDSSSSSRSSSSSSSCSSC
CSSSSSSSCSSRRSSCCSSSSSSSSSSSSC
CSSSSSSSSSSSSSSSSSSSSSTTSSSSSC
CSSSSSSSSSSSSSSCSSSSSSTTSSSSSC
CCCCCCCCCCSSSSSSSSSSSSSSSSSSSC
CSSSSSSSSCCCSSSSSSSSSSCSSSSSSC
CSSRRRSSCSSCCSSSSSSSSRSSSSSSSC
CSSSSSSCSSSSSCCSSSSSDSSSSSSCSC
CSSSSSCSSSSSSSSSSSSSSSSSSSSSSC
CSSSSCSSSSSSDSSSSSSSRSSSSRSSSC
CSSSCSSSSSSSSSSSSRSSSSRRSSSSSC
CSSSSSSSSSSCSSSCSSSSSSCCSSSSSC
CSSRRRSSSSSSSSSSSSSSSSSSSSSSSC
CSSSSSSCSSSCCCCSSSSSSSSSSSSSSC
CSSSSSSSCSSSSSSCSSRRRRRSSSSSSC
CSSSSSSSSSCSSSSSCSSSSSSSSSSSSC
CSSSSSSSSSDSSSSSSCCCCCCCCCCCCC
CSSSSSSSSSSSSSSSSSSSSSSSSSSSSC
CSCCCCCCCSSSSSRRSSSSSSSSSSSSSC
CSSSSSSSSRRSSSSSSSSSSSSSSSSSSC
CSSSSSSSSSSRSSSSSSSSSRSSSSSSSC
CSSSSSSSSSSCCCSSSSSSSSSSSSSSSC
CSRRSSTTSSSSSCSSSSSDSSSSSRSSSC
CSSSSSTTSSSSCSSSSSCCSSSSSSSSSC
CSCCSSSSSSSSCSSSSSSSSSSSSSSSSC
CSSSSSSSSSSSCSSSSCCSSSSSSSSSSC
CDSSSSSSSSSSCSSSSSSSSSSSSCCSSC
CCCCCCCCCCCCCCCCCCCCCCCCCCCCCC