CCCCCCCCCCCCCCCCCCCCCCCCCCCCCC
CTSSSSSSSSSSSSSSCSSSSSSSSSCSDC
CRCRCRCRCRCDSSSSSSRSSSSSSSSSSC
CSSSSSSSCSSRRSCCCSSCSSSSCCSSSC
CSSSSSSSSSSSSSSSSSSSSSTTSSSSSC
CSSSSSSSSSSSSSSCSSSSSTTTSSSSSC
CCCCRRRRRCSSSSSCSTTTTTTSSSSSSC
CSSSSSSSSCCCSSCSCSSSSCCCCCCCRC
CSSRRRSRCSSCCSSSSRSSSRSSSSSSSC
CSSSSSRRRSSSSCCSSSCSSSSSSSSCSC
CSSSSSCRSSSSSSSSSSSCCCSSSSSSSC
CSSSSRSSSSSDDSSSSSSSRSSSSRSSSC
CSSSCSCSSCSSSSSSSRSSSCRRSSSSSC
CSSSSSSSSSSCSSSCSSSSSSCCSSSSSC
CSSRRRSSSSSSSSSSSSSSSSSSSSSSSC
CSSSSSSCSSSCCRCSSSSSSSSSSSSSSC
CSSSSSSSCSSSSSSCSSRRRRRSSSSSSC
CSSSSSSSSCCSSSSSCSSSSSSSSSSSSC
CSSSSSSSSSDSSSSSSCCCCCCCCCCCCC
CSSSSSSSSSSSSSSCSSSSSSSSSSSSSC
CSCCCCCCCSSSSSRRSSSSSSSSSSSSSC
CSSSSSSRRSSSSSSCSSSSSSSSSSSSSC
CSSSSSSSSRSSSSSCSSSSSRRRSSSSSC
CSSSSSSSSSCCCCSCSCRCCCCCCCSSSC
CSCCSSTTSSSSSCSCSCSDSSCSSRSSSC
CSSSSSTTSSSSCSSCSCCCCSSCSSSSSC
CSCCSSSSSSSSCSRSSSSSSSSSCSSSSC
CSCSSSSSSSSSCSCSSCCSSSSSSCSSSC
CDCSSSSSSSSSCSSSSSSSSSSSSCCSSC
CCCCCCCCCCCCCCCCCCCCCCCCCCCCCC