CCCCCCCCCCCCCCCCCCCCCCCCCCCCCC
CTSCSSSCSCSSSSSSSSSSDSCSSSCSRC
CSSCSRSCSSSDCCDSSSSSRCSSSSSSSC
CSSCCSSCCSSRRSSCCSSSCSSSSSSSSC
CSSSSSSSSSSSSSCSSTTTTTTTSSSSSC
CCCCCSSCCCCSSCSTTTTTTTTTSSSSSC
CSSSSSSSSSSSSCSTTSSSSSSSSSSSSC
CSSSSSSSSSSSSCSTTSSSSSCSSSSSSC
CSSSSCSCSRRSCSSSSSSRSSSSSSSSSC
CSSSCSSSSSSSSCCSSSSSDSSSSSSCSC
CCSSSCSSSSSSSSCCSSSSSSSSSSSSSC
CSSSRSSSSSSDDSSSSSSSRSSSSRSSSC
CSRRTSSSSSSSSSSSSRSSSSRRSSSSSC
CSSSTCSSSSSCSSSCSSSSSSCCSSSSSC
CSSRTRCSSSSSSSSSCSSSSSSSSSSSSC
CSSSSSSCSSSCCCCCSSSSSSSSSSSSSC
CSSSSSSSCSSSSSSCSSRRRRRSSSSSSC
CSSSSSSSCTTSSSSSCSSSSSSSSSSSSC
CCCCSSSSCTSSSSSSSCCCCCCCCCCCCC
CSSSSSSSTTSSSSSSSSSSSSSSSSSSSC
CSSSSSTTTSSSSRRSSCSSSSSRRSSSSC
CSSSSSTTSRRSSSSSSCSSSSSSSSSSSC
CSSSSTTTSSSRSSSSSSSSSRSSSSSSSC
CSSSRTCSSSSCCCSSRRSSSSSSSSSSSC
CCCCCTCSSSSSSCSSSSSSSSSSRSSSSC
CSSSSTCSSSSSRSSSSSRRRRCRSSSSSC
CSSSSTCSSSSSRSSSSSSSSSSSSSSSSC
CSSSSSCSSSSSRSSSSRRSSSSSSSSSSC
CDSSSSCSSSSSRSSSSSSSSSSSSCCSSC
CCCCCCCCCCCCCCCCCCCCCCCCCCCCCC