CCCCCCCCCCCCCCCCCCCCCCCCCCCCCC
CTSSSSSCSCSSSSSSSSSSDSCSSSCSRC
CSCSSRSCSSSSCCDSSSSSRCSSSSSSSC
CSSCSSSCCSSRRSSCCSSSCSSCCSSSSC
CSSSCSSSSTTTTTTTTTTTTTTTSSSSSC
CCRCCSSCCTTTTTTTTTTTTTTTSSCSSC
CSSSSSSSSSSSSCCCCSSSSSSSSSSSSC
CSSSSSSSSSSSSCSCCSSSSSCSSSRSSC
CSSSSCSCSRRSCSSSSSSRRRSSSSSSSC
CSSSCSSSSSSSSCCSSSSSDRSSSSSCSC
CSRSSCSSRSSSSSCCSSSSCRSSSSSSSC
CSSSRSSSSSSRDSSSSSSSRSSSSRSSSC
CSRRTSSCSSSSSSSSSRSTSSRRSSSSSC
CSSSTCSSRSSCSSSCSSSSSSCCSSSCCC
CSSRTRCSSSSSSSSSCSSSSSSSSRSSSC
CSSSSSSCSSRCCCCCSSSSCSSSSRSSSC
CSSDSSSSCSSSSSSCSSRRRRRSSCSSSC
CSSRSSSSCTTSSSSSTRSSSSSSCSSSDC
CCRCSSSSCSSSSSCCTCCCCCCCCCCCCC
CSSSCSSSSTSSSSSCTSSSSSSSSSSSSC
CSSSSSSSSSSSRRSCTSSSSSRRRSSSSC
CSSSSSTTSRRSSSSCCCSSCSSSSSSSSC
CSSSSTTTSSSRSSSSSSCSSRSSSSSCSC
CSSSRTCSSSSCCCSSRRSSSSCSSSSSSC
CRCSCTSSCSSSSCSSSSSDSCTRSRSSSC
CSSSSTCSSSSSRSSSSSRRRRTCCCCCCC
CSSSSTSSSSSSRSSSSSSSSCTSSSTSSC
CSSSSSSSCCSSRSSSTRRSSCTSSSSSSC
CCCSSSSSSSSSRSSSSSSSSCSSSRCSDC
CCCCCCCCCCCCCCCCCCCCCCCCCCCCCC