CCCCCCCCCCCCCCCCCCCCCCCCCCCCCC
CTSSSSSSSSSSSSSSSSCSDSSSSSCSRC
CSSCSTTTTTTDCCRSSSCSSCSSSSSSSC
CSSCCTTCTTTRRSSCCSSSSSSSSSSSSC
CSSSSTTSSSSSSSCSSTTTTTTTSSSSSC
CRCSCTTCCCCSSCSTTTTTTTTTSSSSSC
CSSSSTTSSSSSTTTTTCCSSSSSSSSSSC
CDSSSTTSSSTTTTTTTCCSSSCSSCCCCC
CSSSSTTSSRTTCSSSSSCRSSSSSSSSSC
CSSSCTTSSSTTSCCSSSSSDSSSCSSCSC
CSSSSTTSTTTTSSCCSSSSSSSSSSSSSC
CSSSRTTSTTSDDSSSSCSSRSSSSRSSSC
CSRRSTTRRSSSSSSSSRSSSSRRSSSSSC
CSSCSTTSSSSCSSSCSSSSSSCCSSSSSC
CSCSSTTCSCSSSSSCSSSSCCSSSSCCSC
CCSSSTTCSSSCCCCCSSSCSSSSSSSSSC
CSCCSTTSCSSSSSSCSSRRRRRSSSSCSC
CSSSSTTSCSSSSSSSCSSSSSSSSCCSSC
CSSSSTTSSSCSSSSSSSSSSSSCSSSSSC
CSRRSTTCCSSCCCSSSSRRSSSSSCSSSC
CSRSSTTSSSSSSSSSSSRRSSSCSSSSSC
CSSRSTTSRRRSSSSSSSSSSSSSSSSSSC
CSSSSTTSSSSRSSSSSCSCSSSSRRSSSC
CSSSRTTRRSSSSSSSSRRSSSSSSSSSSC
CSSSSTTSSSSCSSSCCSSSSSSRRSSCCC
CCCSSTTSSSSCSCCSSSSSSSSCCSSCSC
CSSSSTTSSSSCSSRRRRSSSSSRRSSDSC
CSSSSSCSSSSCSSSSSSSSSSSCSSSSSC
CRRSSDCSSSSCSSSSSSRRSSSSSCCSSC
CCCCCCCCCCCCCCCCCCCCCCCCCCCCCC