20
12
CCCCCCCCCCCCCCCCCCCC
CPSSSRRSSSSCDDSSRRDC
CDSSDSSSCRSCSDSSRCCC
CCCCCCCCCCSSSRSSSSSC
CDDRSRSRSCSSSDSDSRSC
CSSRSSRSSCCCCDSCCCCC
CRRRCSSSDCSSSSRRSDSC
CDDRCSSSSSRRSSRSDCCC
CSSDSSSDSRRSSSSRSDSC
CDRSCRRSSSSSSSSSRRSC
CSRSCDDSSSRRSSSSSSSC
CCCCCCCCCCCCCCCCCCCC