20
12
CCCCCCCCCCCCCCCCCCCC
CDRSRSRSRSRSRRSRSRSC
CSSSSSSSSSSSSSSSSSSC
CCCCCCCCCCSSSRSSSSSC
CDDSSRSRSCSSSDSDSRSC
CSSRSSRSSCCCCDSCCCCC
CRRRCSSSDCSSSSRRSDSC
CCCCCCCCSSRRSSRSDCCC
CSSDSSSDSRRSSSSRSDSC
CCSCCRRSSSSSCCCCCCCC
CDDSCDDSSSRSSSSSSSPC
CCCCCCCCCCCCCCCCCCCC