20
12
CCCCCCCCCCCCCCCCCCCC
CDDRRSCRRRRRRCSSDDSC
CSSSSSCDDDDDDCSSSSSC
CRRRRSCSSSSSSCSCCCCC
CRRSSSSSSSSSSSSSDDSC
CDSSSSRRSSPSSSSRRSSC
CSSSSSSRSSSSSSSSSSSC
CSSSSSSSSRRSSSSSSSSC
CRRRRSCSSSSSSSCCCCCC
CSSSSSCSDDDSSSSSSSSC
CDDDSSCSSSSSSSSSSDDC
CCCCCCCCCCCCCCCCCCCC