20
12
CCCCCCCCCCCCCCCCCCCC
CSSSRRSSSSCDDSSSSDPC
CDSSDSSSCRSCSDSSRCCC
CSCCCCCCCCSSSRSSSSSC
CDDRSRSRSCSSSDSDSRSC
CCCCCCCCCCCCCDSCCCCC
CRRRCSSSDCSSSSRRSDSC
CDDRCSSSSSRRSRRSDCCC
CSSDSSSDSRRSSSRRSDSC
CDRSCRRSSSSSSSSSRRSC
CSRSCDDSSSRRSSSSSSSC
CCCCCCCCCCCCCCCCCCCC