20
12
CCCCCCCCCCCCCCCCCCCC
CCDSRRRRRPSSRRRRRCDC
CDCSSSSSSSSSSSSSCSDC
CDDCSSSSSSSSSSSCSSSC
CSRRCSSSSSSSSSCCCSSC
CSSSSCSSSSSSSCDRRSSC
CRRSSSCSSSSSCSSSRRSC
CSSSRRRCSSSCSSSSSSSC
CSSSSSSSCSCDDRSSSSSC
CSSSCSSSSSSSSSCCCCCC
CSSSCSSDDSSSDDSRRSSC
CCCCCCCCCCCCCCCCCCCC