40
21
CCCCCCCCCCCCCCCCCCCCCCCCCCCCCCCCCCCCCCCC
CSSSSRRSSSSCDDSSRRDCSSSSSSSSSSSSSSCDDRRC
CSSSDSSSCRSCSDSSRCSSSSSSRRSSSSSSSSSSDSSC
CCSCCCCCCCSSSRSSSSSCDSSRRSSSSCCCCSSDSSSC
CDDRSRSRSCSSSDSDSRSCSSSSSSSSSSSSSSSSSSSC
CSSRSSRSSCCCCDSCCCCCSSSSSSSSSSSSSSSSSSSC
CRRRCSSSDCSSSSRRSDSCSSSSSDDRCRDSSSDSSSSC
CDDRCSSSSSRRSSRSDCCCCCCCSSSSSSCCSDDDSSSC
CSSDSSSDSRRSSSSRSDSSSSSSSSSSSSSSSSSSSSSC
CDRSCRRSSSSSSSSSRRSCSRSRSRSRRRSDDSSSSSSC
CSRSCDDSSSRRSSSSSSSCSDSDSDRRRRSSCSCSSSSC
CSSSSSSDDRRSSDDSSSSSSSSSSSSSRRRRRRSSSSSC
CSSSSSSSSSSRDDSSSSSSSSSSSSSSSSDDDSSSCCCC
CSSSSSSSDRRSSSSSSSSSSSSSSSSSSSSSSSSSSSSC
CCCCCCCCCSSSSSSSSSSCCCCCCCCCSCCCCDDSSSCC
CSSSSSSSSSSSDDDSCSSSSSSSSSSSSSSSSSSSSSSC
CCCCCCSSSSSSSSSSDDDSSSSSSSRRSSSSSSSCCSSC
CRRRRRRSSRRRRRSSSSSRRRDDSSSSSSDDCCCCCCCC
CRRRRRRSSRRRRRSSSSSSSSSRRRDSSSSCCCCCCCCC
CSSSSSSSSSSSSSSSSSDSDSDSDSRRRRRRSSSSSDSC
CCCCCCCCCCCCCCCCCCCCCCCCCCCCCCCCCCCCCCCC
