40
21
CCCCCCCCCCCCCCCCCCCCCCCCCCCCCCCCCCCCCCCC
CCSSSRRSSSSCDDSSRRDCSSSSSSSSSSSSSSCDDRRC
CSCSDSSSCRSCSDSSRCSCSSSSRRSSSSSSSSSSDSSC
CSTCCSSSSSSSSRSSSSSCDSSRRSSSSRRRCSSDSSSC
CDDRSRSRSCSSSDSDSRSCSSCSSSSSSSSSSSSSSSSC
CSSRSSRSSCCCCDSCDDDDSSCSSSSSSSSSSSSSSSSC
CRRRCSSSDCSSSSRRSDSCSSCSSDDRCRDSSSDSSSSC
CDDRCSSSSSRRSSRSDCSSSSCCSSSSSSCCSDDDSSSC
CSSDSSSDSRCCSSSRSDSSSSSSSSSSSSSSSSSSSSSC
CDRSCRRSSSSSSSSSRRSCSRSRSRSRRRSDDSSSSSSC
CSRSCDDSSSRRSSSSSSSTSDSDSDRRRRSSCSCSSSSC
CSSSSSSDDRRSSDDSSSTPTSSSSSSSRRRRRRSSSSSC
CSSSSSSSSSSRDDSSSSSTSSSSSSSSSSDDDSSSCCCC
CSSSSSSSDRRSSSSSSSSSSSSSSSSSSSSSSSSSSSSC
CCCCDDRRCSSSSSSSSSSCCCCRRRCCSCCCCDDSSSCC
CSSSSSSSSSSSDDDSCSSSSSSSSSSSSSSSSSSSSSSC
CCCCCCSSSSSSSCCSDDDSSSSSSSRRSSSSSSSCCSSC
CRSSCSSRRRRRSCSSSRRRDDSSSSSSDDCCCCCCCCSC
CRRRRCRSSRRRRCSSSSSSSSSRRRDSSSSCCCCCCCCC
CSSSSSSSSSSSSCSSSSDSDSDSDSRRRRRRSSSSSDSC
CCCCCCCCCCCCCCCCCCCCCCCCCCCCCCCCCCCCCCCC
