CCCCCCCCCCCCCCCCCCCCCCCCCCCCCC
CCSSSRRSSSSCDDSSRRDCSSSSSSSSSC
CSCSDSSSCRSCSDSSRCSCSSSSRRSSSC
CSTCCSSSSSSSSRSSSSSCDSSRRSSSSC
CDDRSRSRSCSSSDSDSRSCSSCSSSSSSC
CSSRSSRSSCCCCDSCDDDDSSCSSSSSSC
CRRRCSSSDCSSSSRRSDSCSSCSSDDRCC
CDDRCSSSSSRRSSRSDCSSSSCCSSSSSC
CSSDSSSDSRCCSSSRSDSSSSSSSSSSSC
CDRSCRRSSSSSSSSSRRSCSRSRSRSRRC
CSRSCDDSSSRRSSSSSSSSSDSDSDRRRC
CSSSSSSDDRRSSDDSSSSSSSSSSSSSRC
CSSSSSSSSSSRDDSSSSSSSSSSSSSSSC
CSSSSSSSDRRSSSSSSSSSSSSSSSSSSC
CCCCDDRRCSSSSSSSSSSCCCCRRRCCSC
CSSSSSSSSSSSDDDSCSSSSSSSSSSSSC
CCCCCCSSSSSSSCCSDDDSSSSSSSRRSC
CRSSCSSRRRRRSCSSSRRRDDSSSSSSDC
CRRRRCRSSRRRRCSSSSSSSSSRRRDSSC
CSSSSSSSSSSSSCSSSSDSDSDSDSRRRC
CCCCCCCCCCCCCCCCCCCCCCCCCCCCCC
CSSSSSSSDRRSSSSSSSSSSSSSSSSSSC
CCCCDDRRCSSSSSSSSSSCCCCRRRCCSC
CSSSSSSSSSSSDDDSCSSSSSSSSSSSSC
CCCCCCSSSSSSSCCSDDDSSSSSSSRRSC
CRSSCSSRRRRRSCSSSRRRDDSSSSSSDC
CRRRRCRSSRRRRCSSSSSSSSSRRRDSSC
CSSSSSSSSSSSSCSSSSDSDSDSDSRRRC
CSSSSSSSSSSSSCSSSSDSDSDSDSRRRC
CCCCCCCCCCCCCCCCCCCCCCCCCCCCCC
