40
21
CCCCCCCCCCCCCCCCCCCCCCCCCCCCCCCCCCCCCCCC
CRRRRRRRRRRRRRRRRCCCCCCCCSSSSSSSSSCDDRRC
CSCSDSSSCRSCSDSSRCSCSSSSRRSSSSSSSSCSDSSC
CSTCCSSSSSSSSRSSSSSCDSSRRSSSSRRRCSCDSSSC
CDDRSRSRSCSSSDSDSRSCSSCSSSSSSSSSSSCSSSSC
CSSRSSRSSCCCCDSCDDDDSSCSSSSSSSSSSSCSSSSC
CRRRCSSSDCSSSSRRSDSCSSCSSDDRCRDSSSCSSSSC
CDDRCSSSSSRRSSRSDCSSSSCCSSSSSSCCSDCDSSSC
CSSDSSSDSRCCCCCRSDSSSSSSSSSSSSSSSSCCSSSC
CDRSCRRSSSSSSSCCRRSCSRSRSRSRRRSDDSSSSSSC
CSRSCDDSSSRRSSSSCSSSSDSDSDRRRRSSCSCSSSSC
CSSSSSSDDRRSSDDSSCSSSSSSSSSSRRRRRRSSSSSC
CCCCCCCSSSSRDDSSSSCSSSSSSSSSSSDDDSSSCCCC
CSSSSSSSDRRSSSSSSSSCSSSSSSSSSSSSSSSSSSSC
CCSSDDRRCSSSSSSSSSSCCCCRRRCSSSSSSSDSSSCC
CSSSSSSSSSSSDDDSCSSSSSSSSSSSSSSSSSSSSSSC
CCCCCCSSSSSSSCCSDDDSSSSSSSRRSSSSSSSSCSSC
CRSSCSSDDDSSSCSSCCCRDDSSSSSSDDCCCCCTCCSC
CRRRRCRSSRRSSCCCSSSSSSSRRRDSSSSCCCTPTCCC
CSSSSSSSSSSCCCSSSSDSDSDSDSRRRRRRSSSTSDSC
CCCCCCCCCCCCCCCCCCCCCCCCCCCCCCCCCCCCCCCC
