40
21
CCCCCCCCCCCCCCCCCCCCCCCCCCCCCCCCCCCCCCCC
CCCCCRRSSSSCDDSSRRDCSSSSSCCSSSSSSSCDDRRC
CSCCCSSSCRSCSDSSRCSCSSSSRRCSSSSSSSSSDSSC
CSTCCSSSCCCCCRSSSSSCDSSRRSCSSRRRCSSDSSSC
CDDRCRSRSCSSSDSDSRSCSSCSSSCSSSSSSSSSSSSC
CSSRCSRSSCCCCDSCDDDDSSCSSSCSSSSSSSSSSSSC
CRRRCSSSDCSSSSCRSDSCSSCSSDCRCRDSSSDSSSSC
CDDRCSSSSSRRSSCSDCSSSSCCSSCSSSCCSDDDSSSC
CSSDSSSDSRCCSSCRSDSSSSSCCSSSSSSSSSCCCSSC
CDRSCRRSSSSSSSCSRRSCSRSRSRSRRRSDDSSSSSSC
CSRSCDDSSSRRSSCSSSCCSDSDSDRRRRSSCSCSSSSC
CSSSSSSDDRRCCCCSSSCCCSSSSSSSRRRRRRSSSSSC
CSSSSSSSSSSRDTSSCCCCSSSSCCSSSDDDSSSCCCCC
CSSSSSSSDRRSTPTCSSSSSSSSSSSSSSSSSSSSSSSC
CCCCDDRRCSSSSTCSSSSCCCCRRRCCSCCCCDDSSSCC
CSSSSSSSSSSSDCDSCSSSSSSSSSSSSSSSSSSSSSSC
CSSCCSSSSSSSCCSDDDSSSSSSSRRSSSSSSSCCSSCC
CRSSCSSRRRRRSCSSSRRRDDSSSSSSDDCCCCCCCCSC
CRRRRCRSSRRRRCSSSSSSSSSRRRDSSSSCCCCCCCCC
CSSSRRRSSSSSSCSSSSDSDSDSDSRRRRRRSSSSSDSC
CCCCCCCCCCCCCCCCCCCCCCCCCCCCCCCCCCCCCCCC
