40
21
CCCCCCCCCCCCCCCCCCCCCCCCCCCCCCCCCCCCCCCC
CDDDDCSSDDRRRRRSSCRCSSSSSSRRSSDDSCCCCCCC
CSCSDSSSCRSCSDCSRCSCSSSSRRSSSSSSSSSSDSSC
CSTCCSSSSCSSSRSSSSSCDSSRRSSDDRRRCSSDSSSC
CDDCSRSRSCSSSCSDSRSCSSCSCSSSRCRRSSSSSSSC
CSSRSSRSSCSSDSCDDDDSSCSSSSSSSSSSSDDDSSC
CRCRCSSSDCSSSSRRSDSCSSCSSDDRCRDSSSDSSSSC
CDDRCSSSSSRRSCRSDCSSSSCCSSSSSSCCSDDDSSSC
CSSDSSSDSRCCSSSRSDSSSSCSSCSSCSSCSSSCSSSC
CDRSCRRSSSSSSSSSRRSCSRSRSRSRRRSDDSSSSDSC
CSRSCDDSSSRRSSSSSSCCCCSDSDRRRRSSCSCSSSSC
CSSSSSSDDRRSSDDSSCCCCSSSSCSSRRRRRRSSSSSC
CSSSSSSSSSSRDDSSSCCCCCSSSSCSSSDDDSSSDDCC
CSSSSSSSDRRSSSRRRSSSSSSCSSSSSSCSSSSSCSSC
CSSRRDRRCSSSSSSSSSSCCCCRRRCCSDDDCDDSSSCC
CSSSSSSSSSSSDDDSCSSSSSSSSCSSSCSSCSSSSSSC
CCCCCCSSSSSSSCCSDDDSSCSSSSRRSSSSSSSCCSSC
CRSSCSSRRRRRSCSSSSSSDCSSSSSSDCCCRRRCCCSC
CRRRRCRSSRRRRCSSSSSSSSSDDCDSSSSCCCRRRCCC
CSSSSSSSSSSSSCSSSSDSDSDSDSRRRRRRSSSSSDSC
CCCCCCCCCCCCCCCCCCCCCCCCCCCCCCCCCCCCCCCC
